000000000000000000
000000111111000000
000000110011000000
000000110011000000
011111110011111110
011111110011111110
011000000000000110
011111110011111110
011111111111111110
000000000000000000
