111100011010101101
010101100111100110
111011011011011011
100010011100100110
010110000010100010
110100100001110010
010001000001100010
101010101000101011
001011110010100100
100111101110000101
