000111100001111000
001111110011111100
011111111111111110
111111111111111111
111111111111111111
001111111111111100
000001111111100000
000000111111000000
000000011110000000
000000001100000000
