100110000101011100
110000001100000001
001111001101000010
000100001100000000
000101110100000011
011101000100001000
011011000000000001
100010000011000100
000001111111011000
010100011101111010
