100001100100110010
110111111110111010
100011111101111001
011111001010111011
100001110101101000
000011101011101000
100010010010110111
011011101101010101
111000000101111000
100010111111000111
