110101111111101111
111101100010111101
011100111111111100
000101110111000011
101110101001110111
011111110111101111
111110101111101111
111001100011110011
111111100101100010
010001000110010011
