110111110101000010
110110000101101100
101010100010101110
111001011101111110
010011111110110101
011101010101001011
011010000101100000
011111010000110001
000001100001011101
000000110001001100
