000000000100000000
001111000000011110
001111000100011110
000000000100000000
000000001010000000
000001111011110000
001111010001011110
001111000000011110
000000000000000000
111111111011111111

